name	sequence	activity
DNasePeakNoPromoter19704_Reversed	AGGACCGGATCAACTGGAGCACGTCACTTCTGATGGCTTGAAGGCGGAAGTGGCCCGCCTGAGCAAGCAGGTCAAGGTAGAGCGGCTCTCACGTTCAGCCCCGCCCTCTGGTTACGTCATTTGATTGCAATTCCAAGTTCCCACAGATTAGACAGCTAAAAGCATCTGTGTAAAGGCCACAGGCAACTGGAGCCTGATTCCTTCAGTCCTTCCAACATTGCGTGAACCGA	-0.1485
ENSG00000100129_Reversed	AGGACCGGATCAACTGCGGGATAAGACATGGCTGCCTCGCTTGCGAGCACCGCCGGAAAGAGCGAAATGAGCGGCCCGCGCCTGCGTCCTGAGGCCGGAAGTTCAGCCCCACTCGGGCCTGCCGGGAAACCGGAAGCCTTTCCGAGGCCTCTGGCCATCTGAGACAGCCATATCCAGAAGGAAGAGGAGCCGCGTTCCGTGGCTCACACCTGTAACATTGCGTGAACCGA	1.5719
DNasePeakNoPromoter38196	AGGACCGGATCAACTATTTTGCCTACTTTTAACTTCATGGAAACGGAACCAAATAACTTGTGCTCTCTAGTGCCTGGTTTCTCTCATTCAACACTGTGAGATGCGTCCTTATCAACAACACACGTAGCTGTACGTCGTTTGCTCTCATTGATATAAGGCAGGGGTCAGCAAACTCTTTTTGTAAAGAGCGACAGTAAATATTTGAAGCATCACTGCATTGCGTGAACCGA	-0.5389
ENSG00000115137_Reversed	AGGACCGGATCAACTTCCCTCAGGCCTCCTCGTCCAATGGCGGAGCCGCTGCTCTCGTCACCGCCTCGCCTCCGCTGCTCGCCATCCCCGCCGCTGCCTGGCAGCAGGCGCGGGCGGTTGGGAGCGTGGGGAGCCGGGGGAGGGAGACGGGAGTCTCGCGATGCTAGCGCGGGGCTGCTGACGTCATCTGCAGGCCCTGGAGACGCGACTGCAGTCATTGCGTGAACCGA	1.5353
DNasePeakNoPromoter36503_Reversed	AGGACCGGATCAACTTAAAGAAGACGTTTAATCTGCACGCATGTGTTTGAACTGAGTCACTCTTAAGAATGTATGCTCTTTTTGAATTCTACAAGTATTTGGATAGATGTTTACATACCCAAAACACAATCCTTTCCCATGGAATTTAACCAAGATTTTTTGCCCTGGGAAATGAAGAGACCTGGACTTAATTCAACAAAAGCAAATGTGCACAGCATTGCGTGAACCGA	-0.8470
DNasePeakNoPromoter35006_Reversed	AGGACCGGATCAACTTATGGATATTTACTTAAACAATTTCTTAAGTTGACATTTCACCACTTTGTGAACTCCAAAGAATGCGTTATCTGAAAGTACACTAAAGCATCTATCATTCCTTAGGAAATGGCCATCATCTGATTCCTAACTGGTCTACTATTTATATGTTTTGCTGACTCATGGTTCTACCTGAGGCTGAGGGCTTCCAAACTGGCTACCATTGCGTGAACCGA	-0.2634
DNasePeakNoPromoter42363	AGGACCGGATCAACTATATTTCTCTGGAATGATTTAAAGTCCTTTCTCTTCAAGAGCTGTTGCTTCAGATTCAAGAGAGATGAAAGAAAGCTAAATACTTTCTCCTCTTTCTAGATTTATTTATTTAAGCATTCCAGACCTTTGCTCTTTTGTGCTCTTTTGTGCTCCCTGCTCTGTGGCTCTCTCTCTCTATTTCCATCCCACCCCTCCCCTTTCATTGCGTGAACCGA	1.4915
DNasePeakNoPromoter35824_Reversed	AGGACCGGATCAACTCCCCAAATCTTCCAGAAGACTCCATGCAAACCCAGGAAAGATGAGATGTCACTGATTACTCAGGAAAGAGCTAATAATTTGGAAATTCATGTCAACAGAGGATGAGTCATCAAGGCTGTGTCTTGGTGTAGAAAGGATGCTGTGTGGGAGGTCTCCTGGGTCCTTGTGCCAGCTCTATCAGTACCTGCAAGAATATCACACATTGCGTGAACCGA	-0.6102
DNasePeakNoPromoter44075_Reversed	AGGACCGGATCAACTCTTTTCAAATCTAAGTCACTGCCTTCTATTTGTAATGCATCTTCTGTTAGAAAACAAATGCAAATGTATTGCTTCCCCCTAGTGTCAGAGAAAAGGCACAGCGCAGGGACAGAACACGGGGCAAAAAACAGTCAAACGATGTGGATGTGGGTCTTGAAAATGCCACTTCATTCACTCCAAATCTGGGCAAACCACTGACACATTGCGTGAACCGA	-1.2197
DNasePeakNoPromoter60878	AGGACCGGATCAACTGGAAACATTCCAAAAATTTTGCAACAAGCCACTACTGACAAGCTTACCACAAGCTAGACAGTAGTGAAATACCTTCTACAGAATATGCAATATGCTTGAAACACAGAATGTTGTCTTATCTCTCTGGTATTCAGACCTTAGATAAGGGCTGTGAAATGGCTAGCTCTATAGGACAATTTCAGCATACAAATGTTCTGACACATTGCGTGAACCGA	-0.8446
DNasePeakNoPromoter61365	AGGACCGGATCAACTGAAAGCTGGCTTGATTTCACAGGGGAGTTGGAGCCACCAGATCCTCTTGCAAGATTGCCCCAACTTAAACGCCACATAAAACAGCTCCTAATTGACATGGGCAAAGTACAGCAGATAGCAACTCTTTGCTCTGTATGACAACAGTGAACACTTAATGAAAGAATGTGGCTTTCTTCAGTCAAAGCATTTTTATTATCCACCATTGCGTGAACCGA	-0.7206
DNasePeakNoPromoter12046	AGGACCGGATCAACTTTATCTTAACAAGCAGCTCCCCGGCTCTGGCATGAGCACAAGGTCATCTAATTGGTGCCCATTGGAGACGCTCCGTCAGACTCCCCGTTGACATACTGCCATCTGGTGGAGCTGGGCGGGCGGATCAGCTTTCACAGTCTGATGTTGCCTGTGTCTCGACATATGTTTGTTCCCGGTTCCTGCTGATTTTCCTGACAGCTCATTGCGTGAACCGA	-0.5954
DNasePeakNoPromoter2758	AGGACCGGATCAACTTTGGGGGTAGGATATGTCTGACCTTTACCCAGTTACTTAAATCTACTCATGGCTGCTCATGCAAAAGCTCCAGAGCAGCCCTGGATTAATCATTAAGGAAAATAAGCAGGAGCATAGGGGACTAAGGGGAATGCCACAGAGTTGTTTGCCCTAGCTATCATCCTCTTAATTCGTTCACTGCCACACTTGACTTTAGTAGACATTGCGTGAACCGA	0.0562
DNasePeakNoPromoter41834_Reversed	AGGACCGGATCAACTAGAGAAAGCTTTCCTCTCTCTCCCCCACCAGGCCTCACTGTGTCTTGTTTCGGGGACTGAGACCCGGCAGACAGTGACACAGTGACTTCCTTGTCTTCTTGGTTCCCACCAGCTGATGGGCAAGGTCATTTTCAAAGTCCTGACACCTGCTTATCATAACCGCCAGCTGCACTCCACAAAGAAGACCCCTCCCCCACACCCATTGCGTGAACCGA	-0.8550
DNasePeakNoPromoter53423	AGGACCGGATCAACTCGATCAAACTGAGCACCCGGGGGTTTCCCAAACCCAGGGTTACCGGATCCTGAGCATGCGCGGAGGAGGGACAGGGAGCCGCCCACGCCGGGCTCCGCGGCTGCAGTTGCTGTTGTGGCCACAAGGTGGCACTAAGTCTTTGGCGGCCGCTGGCCTTCCCGACCGTGGAAAGTCGGGGCCGGTGGGGCTAGGTAGGAAGACATTGCGTGAACCGA	-0.1993
DNasePeakNoPromoter54819_Reversed	AGGACCGGATCAACTGCTCTTGTTCACATGAGAGCCAGGTGGAGCAGAAGAAAATCTTGAGCTGTGATGCAAGTGCAATGACAGCCTTGTCTGACCGCACTGGGTGCCCTGCAGCTACAATGACTCATCAGAGTTGCCCCATGTTGAACCAAAATGCCCTTGAGATATAAATATCCTTAAAGTACAAAGGGAAATTACCCCAGGCTATATCGATACATTGCGTGAACCGA	-0.4814
DNasePeakNoPromoter12082_Reversed	AGGACCGGATCAACTCTTCCCTGTAGCTGGGCATTAAAAAGATCTTAGCTCAGTAGATAAAACTGGGCCCAGGCAGAAAGCCCTCTAAGCAGTTGCCAAGGCAACAAACCAAACACCCCCATCAGTGAGGTGACAGGGCCTCCCAGTGTCAGGTTATTTAAGCAAATGGAAGCTGCAAGCATTCCTCTGAAAATTCAGCCACAAGCCCTACTCATCATTGCGTGAACCGA	-1.5713
ENSG00000225110	AGGACCGGATCAACTCATTAAGCCCTTACCATGCAGGTCCCGTTGCCAGGGCAACACAGATGTCTCCTCCTGTCTAGCCACTTGTCTTCCACAGAGACTACGAAATTTTTCTTCCTCATCTACCTGGGGCTTCTGGGAGAAGCGGGAAGCCCTGTAGTCTTAGCACAGCGGGCTTTGGAGACCCCTGCGCTGCGCAGCGCGGCCGCGTGACTGAGCATTGCGTGAACCGA	-0.9543
DNasePeakNoPromoter40832	AGGACCGGATCAACTGCATTCTCCTCGCCTGCCGCTCTGCAAGCTGGTGGGACAGAAGCACCTTCCAGCTTTGTGGATGAGTTCTGACGCAGCTGCGGGGCAACAGTGCCCCCTCGTGGCTGCAGCCCCAGCCTGGCCGCTCTGCCTGCAACTAATGGAGGGGTGGATTTGGACAAGTGGCACGGGGGAAAGGTGTTTCTGACTGCAGGAAGGGCCATTGCGTGAACCGA	-0.6810
DNasePeakNoPromoter35476	AGGACCGGATCAACTGAATGACAATGTTTTGGCAAAGTGACCCAGAATAGTGAGGCGTGGCTGAGGCCCAGGAAGCATCCGACAGGTGGCACCCTGGGCCCTGTGAGTTTGGACACAGCAGCTCGAGCTGGGCCACTCCTGCAGGTCAGAGTGAGGAAACAGGCAGAAAATGACGGACAGTCTGTGGAAATGGAAACAATCAGCCACTTGGGGACCATTGCGTGAACCGA	-0.7839
